XXXXXXXXXXX
P  X      X
X XXX XXX X
X  X   X  X
X XXX XXX X
X  X   X  X
X XXX XXX X
X  X   X  X
X XXX XXX X
X      X  K
XXXXXXXXXXX
