XXXXXXXXXXX
P         X
X XXX XXXXX
X X   X X X
X X XXX X X
X X       K
XXXXXXXXXXX