XXXXXXXXXXXXXXXXXXXXXXXXXXXXXXXXXXXXXXXXXXXXXXXXX
P     X       X           X   X     X       X   X
X XXX X XXXXX X XXXXXXXXX X X XXXXX X XXX X X X X
X   X   X   X X   X     X X X     X   X   X X X X
X X XXXXX XXX X X XXX XXX X XXXXX X XXX XXX XXX X
X X   X X   X X X X   X   X X X   X X X   X     X
X XXX X X X X XXX X XXX XXX X X XXX X XXX XXXXX X
X   X X X X   X   X       X   X X   X   X   X X X
XXX X X X XXXXX X XXXXXXXXXXX X XXX X X XXX X X X
X X X X     X   X X   X     X X   X   X   X X   X
X X X XXXXX X XXX X X X XXX X XXX X XXXXXXX X XXX
X   X   X X   X X X X   X X   X X X X   X   X   X
X XXXXX X XXXXX X X XXXXX XXXXX X XXX X X XXXXX X
X X X   X         X X         X X   X X   X     X
X X X X XXXXXXXXXXX X XXXXXXX X XXX X XXXXXXX XXX
X   X X X       X   X X   X       X X   X   X   X
XXX X XXX XXXXX X XXX X X XXXXXXXXX X X X X XXX X
X   X     X     X X     X   X     X X X X X   X X
X XXXXXXXXX XXX X X XXXXXXX X XXX X X X X XXX XXX
X X     X   X X X X X       X   X   X X X X X   X
X X XXX X XXX X X XXX XXXXX XXX XXXXX X X X XXX X
X X   X X X     X     X     X   X     X       X X
X XXXXX X X XXXXXXXXXXX XXXXX X XXXXXXXXXXXXXXX X
X       X X X         X   X X X X     X       X X
XXXXXXX X XXX XXX XXXXXXX X X XXX XXX X XXXXXXX X
X X     X   X X X X     X X X X   X X   X       X
X X XXXXXXX X X X X X XXX X X X XXX XXXXXXXXXXX X
X X     X   X X X   X   X X X X X     X       X X
X XXXXX X XXX X XXXXXXX X X X X X XXXXX X XXX X X
X X     X   X     X   X   X X   X     X X X     X
X X XXXXXXX XXXXX XXX XXXXX XXXXXXX X X X XXXXX X
X       X   X   X   X             X X   X     X X
XXXXXXXXX X X X XXX X XXXXX XXXXX X XXXXX XXX X X
X       X X X X   X X X   X   X X X X   X   X X X
X XXXXX X XXX X XXX X X XXXXX X X XXX X XXX X XXX
X X   X   X   X     X   X     X X X   X   X X   X
X X X XXXXX XXXXXXXXXXX X XXXXX X X XXXXX X XXX X
X   X     X X           X X   X   X X   X X X   X
X XXXXX X X X XXXXXXXXXXX X XXX XXX X XXX XXX X X
X X   X X X X X     X     X X   X   X   X     X X
XXX X XXX X X X XXX X XXXXX X XXX XXXXX XXXXXXX X
X   X X   X X X X   X X           X     X     X X
X XXX X XXX X X X X X XXXXXXXXXXXXX XXXXX X XXX X
X X     X   X X X X X       X             X     X
X XXXXXXX XXX XXX X XXXXXXX X XXXXXXXXXXXXXXXXXXX
X X       X       X X       X     X             X
X X XXXXXXXXXXXXXXXXX XXXXXXXXXXX XXXXXXX XXXXX X
X                     X                   X     K
XXXXXXXXXXXXXXXXXXXXXXXXXXXXXXXXXXXXXXXXXXXXXXXXX
