XXXXXXXXXXX
P         X
X XXX XXX X
X X   X X X
X X XXX X X
X X   X   K
XXXXXXXXXXX