XXXXXXXXXXX
P       X X
X XXXXX X X
X X   X X X
XXXXX X X X
X     X X X
X XXXXX X X
X X   X X X
X X X X X X
X   X     K
XXXXXXXXXXX