XXXXXXXXXXXXXXXXXXXXX
P       X     X     X
X X XXX XXX X X XXX X
X X X       X   X   X
XXX X XXXXX XXXXXXXXX
X   X X   X X       X
X XXX X X XXX XXXXX X
X X   X X     X   X X
X XXX X XXXXXXX X X X
X   X X   X   X X   X
XXX XXXXX XXX X XXX X
X   X     X   X X   X
X XXX XXXXX X X XXXXX
X X   X     X X     X
X X XXXXXXX X XXXXX X
X X X     X X   X X X
X X X XXX X XXX X XXX
X X X   X   X X X   X
X X XXX XXXXX X X X X
X       X         X K
XXXXXXXXXXXXXXXXXXXXX
