XXXXXXXXXXXXXXXXXXXXXXXXXXXXXXXXXXXXXXXXX
P X             X   X     X         X   X
X X XXXXX XXXXX X X X XXX X XXXXX X XXX X
X X X   X   X X   X X X   X X     X     X
X X X XXXXX X XXXXX X X XXXXX XXXXXXXXXXX
X   X     X X         X X   X X         X
X XXX X X X XXXXXXXXXXX X X X X XXXXXXX X
X   X X X X         X     X   X   X   X X
XXX XXX XXXXXXX XXX XXXXXXXXXXXXX XXX X X
X X     X     X   X                   X X
X XXXXX X XXX XXXXXXXXXXXXXXXXXXX XXXXX X
X X     X X X   X       X   X   X X     X
X X XXXXX X XXX X XXXXX X X X X XXX XXX X
X   X   X X   X   X   X   X X X     X   X
X XXX X X X XXXXXXX X XXXXX X XXXXXXX XXX
X X   X   X       X X     X X     X     X
X X XXXXXXX XXXXX X XXX XXX X XXX XXXXXXX
X X     X X X   X X X X X   X X   X     X
X XXXXX X X X XXX X X X X XXXXX XXX XXX X
X X X   X     X   X X X   X   X     X   X
X X X XXXXXXX X X X X XXXXX X XXXXXXX X X
X   X       X X X X X       X X       X X
XXX XXXXXXX XXX X X X X XXXXX X XXXXXXX X
X X   X   X   X X X X X     X   X     X X
X XXX X X XXX X XXX XXXXXXX XXXXX XXX XXX
X X   X X X   X   X X     X       X X   X
X X XXX X X XXX X X X XXX X XXXXXXX XXX X
X       X X   X X     X   X       X   X X
X XXXXXXXXXXX XXXXXXXXX XXXXXXXXX X XXX X
X X         X         X     X       X   X
X X XXXXXXX XXXXX XXX XXXXX XXXXXXXXX X X
X X X     X     X   X   X X   X       X X
X X X XXX XXXXX XXX XXX X XXX X XXXXXXX X
X X X X   X X X   X   X X   X   X     X X
X X X X X X X XXX X XXX X X XXXXX XXXXX X
X X X X X X X X   X X   X X       X   X X
X X X X XXX X X XXXXX XXX X XXX XXX X X X
X X X X     X X X     X X X   X X   X   X
X X X XXXXXXX X X XXXXX X XXX XXX XXXXXXX
X X   X           X         X           K
XXXXXXXXXXXXXXXXXXXXXXXXXXXXXXXXXXXXXXXXX
