XXXXXXXXXXXXXXXXXXXXXXXXXXXXXXXXXXXXXXXXXXXXXXXXXXXXXXXXXXXXXXXXXXXXXXXXXXXXXXXXXXXXXXXXXXXXXXXXXXXXXXXXXXXXXXXXXXXXXXXXXXXXXXXXXXXXXXXXXXXXXXXXXXXXXXXXXXXXXXXXXXXXXXXXXXXXXXXXXXXXXXXXXXXXXXXXXXXXXXXXXXXXXXXXXXXXXXXXXXXXXXXXXXXXXXXXXXXXXXXXXXXXXXXXXXXXXXXXXXXXXXXXXXXXXXXXXXXXXXXXXXXXXXXXXXXXXXXXXXXXX
P     X   X           X   X             X     X   X     X                                 X     X         X       X     X               X   X               X     X   X     X   X         X   X         X     X     X                   X         X       X                   X     X     X X               X
X X X X XXX XXX XXXXX X X X XXXXXXXXXXX X X X X X XXX X X XXXXXXXXXXXXXXXXXXXXX XXXXX XXX XXX XXX XXXXXXX X X XXX X XXXXX X XXXXX XXXXXXX X X X XXXXXXXXX XXX XXX X X X XXX X X X X XXXXX X X XXX XXXXX XXXXX X XXX X XXXXXXXXXXX XXXXXXX XXX XXX XXXXXXX X XXXXXXXXXXXXX XXXXX X X XXX X X X XXXXXXXXXXX X X
X X X   X   X X     X   X X X     X   X X X X   X     X X         X           X X     X X     X   X     X   X   X   X     X X X   X       X X X   X   X   X   X   X X     X   X X X     X   X   X X   X     X X X X   X       X X   X     X X X X         X   X X       X   X   X X   X X   X X         X X X
X X XXX X XXX XXXXX XXX XXX X XXXXX X X X X XXXXXXXXXXXXX XXXXX XXX XXXXXXXXX X X XXXXX X XXXXX XXX XXX XXXXXXX X XXX XXXXX X X XXX XXXXXXX X XXX X X XXXXX XXX XXX XXXXXXXXXXX X XXXXX XXXXXXX X XXX XXXXX X X X XXXXX XXXXX X XXX X XXXXX X X XXXXXXXXX XXX X X XXXXX XXX X XXX XXX X XXX X X XXX XXXXX XXX
X X   X X X   X   X   X X   X     X X X   X         X     X   X X   X       X X X   X     X   X X   X         X X X   X     X X X X X   X   X   X   X X     X X     X   X       X     X X   X   X   X         X X       X   X     X X   X   X X         X X X X X   X       X   X   X   X   X X X   X   X   X
X XXX X X X X X X XXX XXX XXXXXXX X X XXXXXXXXXXXXX X XXXXX X XXX XXXXXXX XXX XXXXX XXXXX X X X X XXX XXXXXXXXX XXX XXX XXXXX X X X XXX X XXXXX XXXXX X XXXXX XXXXXXX X X XXXXXXX XXXXX X XXX XXX X X XXXXXXX X XXXXX XXXXX XXXXX X XXX X X X X XXXXX X X X X X XXX XXXXXXXXXXX XXX XXXXXXXXX X X XXX X XXX X
X   X X X   X X X   X X   X       X X     X     X X   X     X     X     X           X   X X X X X X X       X   X   X X X         X   X X X   X   X   X   X       X   X X X       X     X   X X X X X   X   X X       X       X   X   X X X X X X   X X     X     X   X       X   X           X X X X X     X
XXX X XXXXXXX X XXX X X XXX XXXXXXX X XXX XXX X X XXXXX XXXXXXXXX X XXX XXX XXXXXXX X X XXX X X X X XXXXXXX X XXX XXX X XXXXXXXXXXXXX X X X X XXXXX X XXX XXXXX X X X XXX X XXXXXXX XXXXX X X X X X XXXXX X XXXXXXXXXXX X XXX X XXX X X XXX X XXX X XXX XXXXXXXXX XXX X XXX X XXX XXXXXXXXXXXXX X X X XXXXX X
X X X   X     X   X X   X           X X       X     X   X     X   X X X   X   X   X X X X   X X X       X   X     X   X X               X X X       X X   X     X X X X   X   X   X X     X X X   X       X X     X     X X   X X X X X   X X X   X   X   X     X X X X X X X X   X       X     X   X     X X
X X XXX X XXXXX X XXXXXXXXXXXXXXXXXXX X XXXXXXXXXXX X XXXXX X X XXX X XXX XXXXX X X X X X XXX X XXX XXXXX XXXXXXXXX XXX X XXXXXXXXXXXXX X X XXXXXXXXX X XXX XXXXX XXX X XXXXX XXX X X XXXXX X XXXXXXX XXXXX X XXX X XXXXX XXX X X X XXXXX X X X XXXXX XXXXX XXX X X X X X X XXX XXXXX X XXX XXX XXX XXXXX X X
X X X X   X X   X         X         X X   X       X X X   X X   X   X   X X     X X X X   X X   X   X   X             X   X       X   X X X   X     X X X       X   X X       X   X X     X X       X   X   X X   X   X X   X X   X X   X   X   X   X X     X   X   X   X X     X   X X X   X   X   X     X X
X X X XXXXX X XXXXX XXXXX X XXXXXXX X XXXXX XXXXX XXX X X XXXXX X XXXXX X X XXXXX XXX XXXXX XXXXXXXXX X XXXXXXXXXXXXX XXXXX XXX XXX X XXX XXX X XXX X X XXXXX X XXX X XXXXXXXXX XXX X XXXXX XXXXXXX XXX X XXX X X XXX X XXX XXXXX X X X XXX XXXXXXX X X XXXXX X XXX XXXXX XXXXXXX X X XXX XXX XXX XXX XXXXX X
X   X   X   X X   X   X     X     X X     X   X X   X   X X   X X X     X   X   X   X       X       X X       X       X   X   X X   X     X   X X   X X     X X X       X   X   X   X X   X   X   X X   X   X X X X X     X   X   X X X X   X       X     X   X X   X             X X   X X X X X   X X   X X
X XXX X XXX X XXX XXX XXXXXXX XXX X X XXX XXX X XXX XXXXX X X XXX XXX X XXXXX X XXX XXXXXXX XXX XXX X XXXXXXX X XXXXX X X X XXX X XXXXXXXXX XXX X XXX XXXXX X X XXXXXXX X X X X X XXXXX X X X X X X XXX XXX X X X X XXXXX XXX X XXX X X X XXX X XXXXX XXXXX XXX X XXXXXXXXX XXXXXXX XXX X X X X XXX X X XXX X
X     X X   X       X     X   X   X X X X   X     X   X   X X     X   X   X   X X   X     X   X   X   X   X   X X   X X X   X   X X         X   X       X   X X   X X   X X   X X       X X X   X X   X   X   X X X   X X   X   X   X X   X   X X   X X   X X X X X       X   X   X   X     X X     X X X   X
XXXXXXX X XXXXXXX XXXXX X X XXXXXXX X X X XXXXX XXX XXX X X XXXXXXX XXXXX X X XXX X X XXXXXXX XXX XXXXXXX X XXX X X X XXXXXXX X X XXXXX XXXXXXXXXXXXXXX X XXX XXX X X XXX XXX XXXXXXXXXXX X XXXXXXXXX XXX XXXXX X X X X XXX XXXXX X X XXXXX XXX X X XXX X X X X X X X XXX XXX X X XXX XXXXXXX X XXXXX X X XXX
X     X X     X   X   X X X     X   X X X       X   X   X X X         X X X X   X X X   X   X     X     X X X   X X X     X   X X     X             X X X X   X   X X     X   X       X   X     X     X X   X   X   X     X     X X X X X     X X X     X X X   X X X   X     X X   X X       X   X   X X   X
X X XXX X XXX X XXX X X X XXXXX X XXX X XXXXXXX X X X XXXXX XXXXXXX X X X XXXXX X X XXX X X XXXXXXX XXX X X XXX X X XXXXX X XXX XXXXX XXXXXXXXXXXXX X X X XXXXX XXX XXX XXXXXXX XXXXX X XXX XXX X XXXXX XXX X XXXXXXXXXXX XXXXX X XXX X X XXX X X XXXXXXX X XXX X X XXX XXXXXXX XXX X X XXX XXXXXXX XXX XXX X
X X X   X X X X X X X X X     X X X     X     X X X X X     X     X X X X   X   X X   X   X         X     X   X X X     X X X X X   X             X X   X     X X     X X     X   X   X   X   X X     X   X X     X           X X     X   X   X X X     X X   X X X X   X     X X   X X   X X     X   X     X
X XXX XXX X X X X X X XXXXXXX X X XXXXXXX XXX XXX X X X XXXXX XXX X X X XXX X XXX XXX XXXXXXXXX XXXXXXXXXXXXX X XXX XXXXX X X X X XXXXXXXXXXX XXX X XXXXXXXXX X X X XXX X XXX XXX XXX XXX XXX X XXXXX X X X XXXXX XXXXXXXXXXX X XXXXXXXXXXX XXXXX XXX X X X X XXX XXX XXX XXX X X XXX XXX X X XXX XXX X XXXXX
X X   X     X   X X X X     X X X     X   X X     X X X   X   X X X X X       X   X             X           X X   X     X X X   X       X   X   X X         X   X X     X   X   X   X   X X   X     X X X   X   X       X   X X   X       X X   X   X X   X X   X     X X   X X X         X X X X   X X X   X
X X XXXXXXX XXXXX X X X XXX X X XXXXX X XXX XXXXXXX X XXX X XXX X XXX XXXXXXXXX XXXXXXX XXXXXXXXX XXXXXXXXX X XXX X XXX X X X XXXXXXX X X X XXXXX X XXXXXXX XXXXX XXXXXXX XXXXX XXXXXXX X XXX XXX XXX X XXXXXXX XXXXXXX X X XXXXX X XXXXX X X X XXX XXXXX XXXXX XXXXXXX X X XXX XXXXXXXXX XXX X XXX X X XXX X
X X X   X     X   X X   X X   X X   X X X           X     X   X     X         X     X   X       X X       X X     X   X X X X X       X X X   X   X X     X   X X X       X   X   X     X   X   X   X X X         X   X X X       X X       X X     X   X   X     X X   X X X   X   X   X X   X   X   X   X X
X X X X XXXXX XXX X XXXXX XXXXX X X X X XXXXXXXXXXXXXXXXXXX X XXXXX X XXXXXXX XXXXX X XXX XXXXX X X X XXXXX XXXXXXXXX X X X X XXX XXXXX X XXX X XXX X XXX X X X X X XXXXXXX X X X X XXXXX X XXXXXXX X X X XXXXXXX X X X X XXXXXXXXX XXXXXXX X XXXXX X X XXX X XXX X X X X X X XXXXX X X XXX XXX XXX XXXXX X X
X   X X     X     X   X     X X   X   X X     X         X   X   X X X       X   X   X   X X   X   X X     X   X     X X X   X     X     X X   X   X   X   X X   X X   X   X X   X X X     X   X     X X   X X     X X X X   X   X   X   X   X   X   X X X X   X   X X X   X   X     X X     X       X   X   X
X XXX XXXXX XXXXXXXXX X XXX X X XXXXXXX X XXX X XXX XXX XXXXXXX X X XXX XXXXX X X XXXXX X X X XXXXXXXXXXX XXX X XXX X X XXXXXXXXXXX XXXXX XXX XXX XXXXX XXX XXXXX XXX X X X XXXXX X X XXXXXXX X X XXX XXXXX X XXXXX XXX XXX X X X X X X XXXXXXX XXXXX X X XXXXX XXX X XXXXXXXXX XXXXX XXXXXXXXXXXXXXX X XXX X
X     X   X     X     X X X X X     X   X   X   X X X X     X   X   X   X   X X X   X   X X X   X     X     X X X X   X   X       X X   X   X   X X       X     X X X X X X X     X X X     X X X X   X   X   X   X   X     X X   X X X       X   X   X X           X X             X           X     X   X X
XXXXXXX X XXXXX X XXXXX X X X XXXXX X X XXX XXXXX X X XXXXX X XXX XXXXXXX X XXX XXX XXXXX X XXX X XXX X XXXXX X X XXXXXXX X X XXX X X X XXX XXX X XXXXXXXXXXXXX X X X XXX X XXXXXXX XXX XXX X X XXX XXX XXX XXX X X X XXXXXXXXXXXXX X XXXXXXX XXX X XXX XXX XXXXXXXXX X XXXXXXX XXX XXXXXXXXXXX X XXXXXXX XXX
X       X   X X X   X   X X X     X X X   X X     X X   X   X   X   X   X X   X   X     X X   X   X   X X     X X   X   X   X   X X   X X X X     X           X     X     X       X   X   X   X X   X     X   X X X X             X X X     X   X X X X   X X   X     X X     X X X         X   X X     X   X
X XXXXXXXXX X X XXX XXX X X X XXX X XXXXX X XXXXX X XXX X XXXXX XXX X X X XXX XXX XXXXX X XXX XXXXX XXX X XXXXX X X XXX XXXXXXX X XXXXX X X XXXXX X XXXXXXXXX XXXXXXXXXXX XXXXXXX XXX XXX XXXXX X XXXXXXX XXX X X XXX XXXXXXX XXX X X XXXXX XXX X X X XXX XXX X X XXXXX X XXX X X XXX XXXXXXX XXX XXXXX XXX X
X   X     X   X     X   X X   X   X   X   X     X X   X X     X   X X X X X       X   X       X         X X     X X   X   X   X X   X X   X   X X X   X     X   X     X   X     X   X   X   X   X X       X     X   X   X   X   X   X X   X X   X X   X X     X   X X   X X X X     X       X   X X   X   X X
XXX X XXXXXXX XXXXXXX XXX XXX XXXXXXX X XXXXXXX X XXX X XXXXX XXX X X X X XXXXXXX XXX XXXXXXXXXXXXX XXXXX X XXXXX XXX X X XXX X XXX X XXX XXX X X XXX X XXX XXX X XXX X XXX XXXXXXX XXX XXX XXX X X XXXXXXX XXXXXXX XXXXX X XXX XXXXX X X X X XXX XXX X XXXXXXXXXXX X XXX X X XXXXXXX XXXXX XXX X X X XXX X X
X   X       X X     X   X     X     X X X     X X X   X   X       X   X   X   X X   X     X       X X     X X     X X   X     X   X   X X X   X   X X X   X   X   X X   X     X   X   X   X   X   X         X   X       X X     X     X X   X X     X X   X     X       X X X X     X     X   X     X     X X
X XXX XXXXX X X XXXXX X XXX XXX X XXX X X X XXX X X XXX XXX XXXXX XXXXXXX X X X XXX XXX X X XXXXX XXX XXX X XXX XXX XXXXXXXXX XXX XXX X X X XXXXX X X XXX XXX XXXXX XXXXX XXX X X XXX XXX X X X XXXXXXXXXXX X X XXXXXXX X XXXXX X XXXXX XXX X XXX XXX X X X XXXXX XXXXXXX X X X XXX X XXXXX X XXXXXXX XXXXX X
X X X X   X X   X     X   X   X X     X   X X   X X X   X   X   X X   X   X X X         X X X   X   X X   X     X       X X   X X   X X X X     X   X X X X   X   X     X   X X X   X     X X X           X X X   X   X   X X   X X     X   X   X     X X X       X X     X X X X   X X   X X X     X X     X
X X X X XXX XXX X XXXXXXX XXX X XXXXXXXXXXX X XXX X X X X XXX X XXX X X XXX X XXX XXXXXXX X X XXXXX X X XXXXXXXXX XXX X X X XXX XXX X X X XXXXX XXXXX X X X X X XXX X X X XXX X X XXXXXXXXXXX XXXXXXXXXXX X X XXX X X XXXXX X XXX X X XXXXXXXXX XXX XXX X XXX XXXXX X XXXXX X X XXX XXX X X X X XXX XXX XXXXX
X X     X   X   X       X   X X   X         X X   X X X X   X X     X X X   X   X   X   X X X         X   X   X   X X X   X X   X   X   X     X X     X   X X X X   X X X X   X X       X     X     X     X X X   X X   X   X   X X X   X     X   X     X   X       X X   X   X   X X   X   X X   X X   X   X
X XXXXXXX XXX XXXXXXXXX XXX X XXX XXX X XXXXX XXX X X XXXXX X XXXXXXX XXX XXXXX XXXXX X XXX X XXXXXXXXXXXXX X X XXX X XXXXX XXX X XXXXX XXXXX X X XXXXX XXX X X X XXX X X X XXX XXXXX X X XXXXXXXXX X XXXXXXX XXX X XXX XXX X XXX X XXX X XXX XXX XXXXXXXXX XXXXXXX X X X X XXXXX X X XXX XXXXXXX X X XXX X X
X       X         X   X X X X   X   X X   X   X   X X X   X X X   X       X   X       X     X X       X   X X   X   X       X   X     X   X   X   X X   X   X X X   X X X X         X X X X       X X       X   X   X X   X   X   X   X X X X   X       X X X   X   X   X X       X   X   X       X X     X X
X XXXXX XXXXXXXXX X XXX X X XXXXXXX X XXX X XXX XXX X X X X X X X XXXXXXXXX X XXX XXXXXXXXX XXX XXXXX X X X XXXXXXX XXXXXXXXX X XXXXX XXXXX XXXXXXX X XXX XXX X XXX X X XXXXXXX XXXXX X X X X XXX X XXXXXXX XXX XXXXX XXX X XXX XXX XXX X X XXX XXXXXXX X X X X XXXXXXXXX X XXXXXXXXXXX XXX XXXXXXX X XXXXX X
X X   X X   X   X   X   X X       X X   X X   X   X X   X   X X X     X     X X   X     X   X   X   X   X   X     X           X X X   X     X     X   X   X X X   X X X       X X     X   X X X     X     X   X X   X     X X   X X X   X X X         X X X   X           X X     X       X X   X   X X X   X
X X X X X X X X XXXXX XXX XXXXX XXX XXX X XXX XXX X X XXXXXXX X XXXXX X XXXXX X XXX XXX X XXX XXX XXXXXXXXXXX XXX XXXXXXX X XXX X X XXX XXXXX X X XXX X XXX X X X X X XXXXXXX XXX XXXXXXXXXXX XXXXXXX XXX XXX X XXX X XXXXX X XXX X X XXX X X XXXXXXXXX X XXXXXXXXX XXXXXXXXX XXX X XXXXXXX X X X XXX X X X X
X X X   X X   X X     X       X   X   X X   X   X X X     X   X X   X X     X     X   X X X   X             X X X   X   X X   X X X     X     X X   X X X   X X X X X X     X X   X     X     X         X   X X   X X X     X X   X X   X X X     X   X X           X     X   X X X X     X   X X X     X X X
X X XXXXX XXXXX X XXXXXXX XXX XXX XXX X X XXXXX X X XXXXX X XXX XXX X XXX XXXXX XXX XXX XXX XXX XXXXX XXX X X X XXX X X XXXXX X X XXXXXXXXXXXXX XXX XXX X X X X X X X X X XXX X XXX X X X XXXXX XXXXXXXXX XXX XXX X X XXXXXXX XXX X XXX X X XXXXX X X X X XXXXXXX XXX XXX X XXX X X X XXX XXXXX X X XXXXX X X
X X     X X X   X X       X   X X X   X X         X   X   X   X   X X   X X   X X   X   X   X   X   X X   X   X X   X X X     X X         X     X X   X X X   X X   X X X     X X X X X   X   X X   X     X   X   X   X       X   X X   X     X X X X   X X     X   X   X X X X   X X   X       X X   X   X X
X XXXXX X X X XXX XXXXX XXX XXX X X XXXXXXXXXXXXXXXXX X XXXXX XXX X XXX XXX X XXX XXX XXX XXXXXXX X XXX XXXXXXX X XXX X X XXXXX X XXXXXXX X XXXXX XXX X X XXXXXXXXXXX X XXXXXXX X X X XXXXX X X X X X XXXXX XXX XXX XXX XXXXXXX XXX X XXXXXXX X X X XXXXXXX XXX XXXXXXX X X X X XXXXXXX XXXXXXXXX XXXXX XXX X
X     X     X           X       X                     X     X         X     X       X             X     X             X   X       X         X           X             X         X   X       X     X X           X       X           X           X           X           X   X           X               X   K
XXXXXXXXXXXXXXXXXXXXXXXXXXXXXXXXXXXXXXXXXXXXXXXXXXXXXXXXXXXXXXXXXXXXXXXXXXXXXXXXXXXXXXXXXXXXXXXXXXXXXXXXXXXXXXXXXXXXXXXXXXXXXXXXXXXXXXXXXXXXXXXXXXXXXXXXXXXXXXXXXXXXXXXXXXXXXXXXXXXXXXXXXXXXXXXXXXXXXXXXXXXXXXXXXXXXXXXXXXXXXXXXXXXXXXXXXXXXXXXXXXXXXXXXXXXXXXXXXXXXXXXXXXXXXXXXXXXXXXXXXXXXXXXXXXXXXXXXXXXXX
